32,0,0,0,24,24,0,0,0,14,0,0,0,0,0
0,0,0,0,0,0,0,0,0,0,62,0,0,0,42
0,0,0,0,0,0,0,0,0,0,0,0,0,0,0
0,0,0,0,0,0,0,0,0,0,62,0,0,0,42
0,0,0,0,72,94,0,0,0,0,0,0,0,0,0
62,0,0,0,42,68,0,0,0,48,62,0,0,0,42
0,0,0,0,0,0,0,0,0,0,0,0,0,0,0
62,0,0,0,42,68,0,58,0,48,62,0,0,0,42
0,0,0,0,0,0,0,0,0,0,0,0,0,0,0
62,0,0,0,42,68,0,0,0,48,62,0,0,0,42
0,0,0,0,0,0,0,0,0,18,34,0,0,0,0
62,0,0,0,42,0,0,0,0,0,0,0,0,0,0
0,0,0,0,0,0,0,0,0,0,0,0,0,0,0
62,0,0,0,42,0,0,0,0,0,0,0,0,0,0
0,0,0,0,0,98,0,0,0,84,84,0,0,0,74