9,0,0,0,7,0,1,0,1,7,9,0,0,0,0
6,0,0,0,0,0,0,0,0,0,0,0,0,0,4
0,0,0,0,0,0,0,0,0,0,6,0,0,0,0
6,0,0,0,0,0,0,0,0,4,0,0,0,0,4
0,0,0,0,1,3,0,0,0,0,6,0,0,0,0
6,0,0,0,0,0,0,0,0,4,0,0,0,0,4
0,0,0,0,4,6,0,0,0,0,6,0,0,0,0
6,0,0,0,0,0,0,0,0,4,0,0,0,0,4
0,0,0,0,4,6,0,0,0,0,6,0,0,0,0
6,0,0,0,0,0,0,0,0,4,0,0,0,0,4
0,0,0,0,4,6,0,0,0,7,9,0,0,0,0
6,0,0,0,0,0,0,0,0,0,0,0,0,0,4
0,0,0,0,4,6,0,0,0,0,0,0,0,0,0
6,0,0,0,0,0,0,0,0,0,0,0,0,0,4
0,0,0,0,0,3,0,1,0,1,0,2,0,2,0