1,1,1,1,1
1,5,2,34,1
1,35,12,13,1
1,24,23,15,1
1,1,1,1,1