1,1,1,1,1,1,1,1,1,1,1,33,33,33,1
1,2,2,5,2,2,5,2,2,1,1,2,2,2,1
1,2,3,2,2,2,2,3,2,1,1,2,2,2,1
1,4,2,2,2,2,2,2,4,1,1,2,2,2,1
1,2,2,2,1,1,2,2,2,1,1,2,2,2,1
1,2,2,2,1,1,2,2,2,1,1,2,2,2,1
1,2,2,2,1,1,2,2,2,1,1,2,2,2,1
1,2,2,2,1,1,2,2,2,1,1,2,2,2,1
1,2,2,2,1,1,2,2,2,1,1,2,2,2,1
1,2,2,2,1,1,2,2,2,1,1,2,2,2,1
1,2,2,2,1,1,2,2,2,1,1,2,2,2,1
1,2,2,2,1,1,5,2,2,2,2,2,2,5,1
1,2,2,2,1,1,2,3,2,2,2,2,3,2,1
1,2,2,2,1,1,2,2,4,2,2,4,2,2,1
1,31,31,31,1,1,1,1,1,1,1,1,1,1,1