1,1,1,1,1,1,1,1,1,1,1,33,33,33,1
1,2,2,2,2,2,2,2,2,1,1,2,2,2,1
1,2,3,2,2,2,2,3,2,1,1,2,2,2,1
1,2,2,2,2,2,2,2,2,1,1,2,2,2,1
1,2,2,2,1,1,2,2,2,1,1,2,2,2,1
1,2,2,2,1,1,2,2,2,1,1,2,2,2,1
1,2,2,2,1,1,2,2,2,1,1,2,2,2,1
1,2,2,2,1,1,2,2,2,1,1,2,2,2,1
1,2,2,2,1,1,2,2,2,1,1,2,2,2,1
1,2,2,2,1,1,2,2,2,1,1,2,2,2,1
1,2,2,2,1,1,2,2,2,1,1,2,2,2,1
1,2,2,2,1,1,2,2,2,2,2,2,2,2,1
1,2,2,2,1,1,2,3,2,2,2,2,3,2,1
1,2,2,2,1,1,2,2,2,2,2,2,2,2,1
1,36,36,36,1,1,1,1,1,1,1,1,1,1,1